12 12
############
#         N#
#   ########
#          #
########   #
#          #
#   ########
#          #
########## #
#  =       #
############
            
